BBBBBBBBBBBBBBBBBBBBBBBBBBBBBBBBBBBBBBBBBBBBBBBBBB
B________________________________________________B
B________________________________________________B
B________________________________________________B
B________________________________________________B
B________________________________________________B
B________________________________________________B
B________________________________________________B
B________________________________________________B
B________________________________________________B
B________________________________________________B
B________________________________________________B
B________________________________________________B
B________________________________________________B
B________________________________________________B
B________________________________________________B
B________________________________________________B
B________________________________________________B
B________________________________________________B
B________________________________________________B
B______________CCC______CCC______________________B
B_______CCC______________________________________B
B___P____________________________________________B
B________________________________________________B
BBBBBBBBBBBBBBBBBBBBBBBBBBBBBBBBBBBBBBBBBBBBBBBBBB

// _ == Air
// P == Player
// B == Brick
// G == Grass
// C == Coin
// 50x25 levels