BBBBBBBBBBBBBBBBBBBBBBBBBBBBBBBBBBBBBBBBBBBBBBBBBB
B________________________________________________B
B________________________________________________B
B________________________________________________B
B________________________________________________B
B________________________________________________B
B________________________________________________B
B________________________________________________B
B________________________________________________B
B________________________________________________B
B________________________________________________B
B________________________________________________B
B________________________________________________B
B________________________________________________B
B________________________________________________B
B________________________________________________B
B________________________________________________B
B________________________________________________B
B___BBBBB___________BBBBBBBBBBB__________________B
B________________________________________________B
B_________________B______________BBBBBBBB________B
B_______________BBB______BBB_____________________B
B___P_________BBBBB______________________________B
B___________BBBBBBB_______________E______________B
GGGGGGGGGGGGGGGGGGGGGGGGGGGGGGGGGGGGGGGGGGGGGGGGGG

// _ == Air
// P == Player
// B == Brick
// G == Grass
// C == Coin
// E == Enemy
// 50x25 levels