BBBBBBBBBBBBBBBBBBBBBBBBBBBBBBBBBBBBBBBBBBBBBBBBBB
B________________________________________________B
B________________________________________________B
B________________________________________________B
B________________________________________________B
B________________________________________________B
B________________________________________________B
B________________________________________________B
B________________________________________________B
B________________________________________________B
B________________________________________________B
B________________________________________________B
B________________________________________________B
B________________________________________________B
B________________________________________________B
B________________________________________________B
B________________________________________________B
B________________________________________________B
B________________________________________________B
B________________________________________________B
B________________________________________________B
B________________________________________________B
B___P____________________________________________B
B________________________________________________B
BBBBBBBBBBBBBBBBBBBBBBBBBBBBBBBBBBBBBBBBBBBBBBBBBB

// _ == Air
// P == Player
// B == Brick
// G == Grass
// 50x25 levels