BBBBBBBBBBBBBBBBBBBBBBBBBBBBBBBBBBBBBBBBBBBBBBBBBB
B________________________________________________B
B________________________________________________B
B________________________________________________B
B________________________________________________B
B________________________________________________B
B________________________________________________B
B________________________________________________B
B________________________________________________B
B________________________________________________B
B________________________________________________B
B________________________________________________B
B________________________________________________B
B________________________________________________B
B________________________________________________B
B________________________________________________B
B________________________________________________B
B________________________________________________B
B___BBBBB___________BBBBBBBBBBB__________________B
B________________________________________________B
B_________________B______________BBBBBBBB________B
B_______________BBB______________________________B
B___P_________BBBBB______BBBBB___________________B
B___________BBBBBBB______________________________B
GGGGGGGGGGGGGGGGGGGGGGGGGGGGGGGGGGGGGGGGGGGGGGGGGG

// _ == Air
// P == Player
// B == Brick
// G == Grass
// C == Coin
// 50x25 levels