BBBBBBBBBBBBBBBBBBBBBBBBBBBBBBBBBBBBBBBBBBBBBBBBBB
B________________________________________________B
B________________________________________________B
B________________________________________________B
B________________________________________________B
B________________________________________________B
B________________________________________________B
B________________________________________________B
B________________________________________________B
B________________________________________________B
B________________________________________________B
B________________________________________________B
B________________________________________________B
B________________________________________________B
B________________________________________________B
B________________________________________________B
B________________________________________________B
B________________________________________________B
B________________________________________________B
B________________________________________________B
B________________________________________________B
B________________________________________________B
B___P___CCC___CCC___CCC___CCC____________________B
B________________________________________________B
BBBBBBBBBBBBBBBBBBBBBBBBBBBBBBBBBBBBBBBBBBBBBBBBBB

// _ == Air
// P == Player
// B == Brick
// G == Grass
// C == Coin
// 50x25 levels